TTTTTTTTTT
T..T..M..T
T.T..M...T
TT....TT.T
T....T...T
T...T...PT
TT..T....T
T.WH.....T
TP......TT
TTTTTTTTTT
